w-w-w-w-w-w-w-w-w-w-w-w-w-w-w-w-
w-l-l-l-l-l-l-l-l-l-l-l-l-l-l-w-
w-l-l-h-l-l-l-l-l-l-l-h-l-l-l-w-
w-l-l-u-u-l-l-l-l-l-l-u-u-l-l-w-
w-l-l-u-u-l-l-l-l-l-l-u-u-l-l-w-
w-l-l-l-h-l-l-l-l-l-l-l-h-l-l-w-
w-l-l-l-l-l-l-h-l-l-l-l-l-l-l-d-
w-l-l-l-l-l-l-u-u-l-l-l-l-l-l-d-
w-l-l-l-l-l-l-u-u-l-l-l-l-l-l-d-
w-l-l-l-l-l-l-l-h-l-l-l-l-l-l-d-
w-l-l-l-l-l-l-l-l-l-l-l-l-l-l-w-
w-l-l-h-l-l-l-l-l-l-l-h-l-l-l-w-
w-l-l-u-u-l-l-l-l-l-l-u-u-l-l-w-
w-l-l-u-u-l-l-l-l-l-l-u-u-l-l-w-
w-l-l-l-r-l-l-l-l-l-l-l-h-l-l-w-
w-l-l-l-l-l-l-l-l-l-l-l-l-l-l-w-
w-w-w-w-w-w-w-w-w-w-w-w-w-w-w-w-