w-w-w-w-w-w-d-d-d-d-w-w-w-w-w-w-
w-w-w-w-w-w-l-l-l-l-w-w-w-w-w-w-
w-w-w-w-w-w-l-l-l-l-w-w-w-w-w-w-
w-w-w-w-w-w-l-l-l-l-w-w-w-w-w-w-
w-w-w-w-w-w-l-l-l-l-w-w-w-w-w-w-
w-w-w-w-w-w-l-l-l-l-w-w-w-w-w-w-
w-w-w-w-w-w-l-l-l-l-w-w-w-w-w-w-
d-l-l-l-l-l-l-l-l-l-l-l-l-l-l-d-
d-l-l-l-l-l-l-l-l-l-l-l-l-l-l-d-
d-l-l-l-l-l-l-l-l-l-l-l-l-l-l-d-
d-l-l-l-l-l-l-l-l-l-l-l-l-l-l-d-
w-w-w-w-w-w-l-l-l-l-w-w-w-w-w-w-
w-w-w-w-w-w-l-l-l-l-w-w-w-w-w-w-
w-w-w-w-w-w-l-l-l-l-w-w-w-w-w-w-
w-w-w-w-w-w-l-l-l-l-w-w-w-w-w-w-
w-w-w-w-w-w-l-l-l-l-w-w-w-w-w-w-
w-w-w-w-w-w-d-d-d-d-w-w-w-w-w-w-