w-w-w-w-w-w-w-w-w-w-d-d-d-d-w-w-w-w-w-w-w-w-w-w-
w-w-l-l-l-l-l-l-l-l-l-l-l-l-l-l-l-l-l-l-l-l-w-w-
w-l-l-l-l-l-l-l-l-l-l-l-l-l-l-l-l-l-l-l-l-l-l-w-
w-l-l-l-l-l-l-l-l-l-l-l-l-l-l-l-l-l-l-l-l-l-l-w-
w-l-l-l-l-u-u-u-u-u-u-u-u-u-u-u-u-u-u-l-l-l-l-w-
w-l-g-g-l-l-l-l-l-l-l-l-l-l-l-l-l-l-l-l-l-l-l-w-
w-l-g-g-l-l-l-l-l-l-l-l-l-l-l-l-l-l-l-l-l-l-l-w-
w-l-l-l-l-l-l-l-r-l-l-l-l-l-l-l-m-l-l-l-l-l-l-w-
w-l-l-l-l-b-b-b-b-m-l-l-l-l-l-u-u-u-u-l-l-l-l-w-
w-l-l-l-l-l-l-l-l-l-l-l-l-l-l-l-r-l-l-l-l-l-l-w-
d-l-l-l-l-l-l-l-l-l-l-l-m-l-l-l-l-g-g-l-l-l-l-d-
d-l-l-l-l-l-l-l-l-l-u-u-u-u-l-l-l-g-g-l-l-l-l-d-
d-l-l-l-l-g-g-l-l-l-u-u-u-u-l-l-l-l-l-l-l-l-l-d-
d-l-l-l-l-g-g-l-l-l-l-r-l-l-l-l-l-l-l-l-l-l-l-d-
w-l-l-l-l-l-l-m-l-l-l-l-l-l-l-l-l-l-l-l-l-l-l-w-
w-l-l-l-l-u-u-u-u-l-l-l-l-l-m-b-b-b-b-l-l-l-l-w-
w-l-l-l-l-l-l-l-l-l-l-l-l-l-l-l-l-l-l-l-l-l-l-w-
w-l-l-l-l-l-l-l-l-l-l-l-l-l-l-l-l-l-l-l-g-g-l-w-
w-l-l-l-l-l-l-l-l-l-l-l-l-l-l-l-l-l-l-l-g-g-l-w-
w-l-l-l-l-u-u-u-u-u-u-u-u-u-u-u-u-u-u-l-l-l-l-w-
w-l-l-l-l-l-l-l-l-l-l-l-l-l-l-l-l-l-l-l-l-l-l-w-
w-l-l-l-l-l-l-l-l-l-l-l-l-l-l-l-l-l-l-l-l-l-l-w-
w-w-l-l-l-l-l-l-l-l-l-l-l-l-l-l-l-l-l-l-l-l-w-w-
w-w-w-w-w-w-w-w-w-w-d-d-d-d-w-w-w-w-w-w-w-w-w-w-