w-w-w-w-w-w-w-w-w-w-w-w-w-w-w-w-w-w-w-w-w-w-w-w-w-w-w-w-w-w-w-w-w-w-w-w-w-w-w-w-w-w-w-w-w-w-w-w-w-w-d-d-d-d-w-w-w-w-w-w-w-w-w-w-
w-l-l-l-l-l-l-l-l-l-l-l-l-l-l-l-l-l-l-l-l-l-l-l-l-l-l-l-l-b-l-l-l-w-w-w-w-l-l-l-l-l-l-l-l-m-l-l-l-l-l-l-l-l-l-l-l-l-l-l-l-l-l-w-
w-l-l-l-l-l-l-l-l-l-l-l-l-l-l-l-l-l-l-l-l-l-l-l-l-l-l-l-l-b-l-l-l-w-w-w-w-l-l-l-l-l-l-l-l-l-l-l-l-l-l-l-l-l-l-r-l-l-l-l-l-l-l-w-
w-l-l-l-l-l-r-l-l-l-l-l-l-l-l-l-l-l-l-l-l-l-l-l-l-l-l-l-l-b-l-q-l-w-w-w-w-l-l-l-l-l-l-l-l-l-l-l-l-l-l-l-l-l-l-l-l-l-l-l-l-l-l-w-
w-l-l-l-l-l-l-l-l-l-l-l-l-l-l-m-l-l-l-l-l-l-l-l-l-l-l-l-l-b-l-l-l-w-w-w-w-l-l-l-l-l-l-l-l-l-l-m-l-l-l-l-l-u-u-u-u-l-l-l-l-l-l-w-
w-l-l-l-u-u-u-u-l-l-l-l-l-l-l-l-l-l-l-l-l-w-w-w-w-l-l-l-l-w-w-w-w-w-w-w-w-w-w-w-w-l-l-l-l-l-l-l-l-l-l-l-l-l-l-l-l-l-l-m-l-l-l-w-
w-l-l-l-l-l-l-l-l-l-l-l-l-l-l-l-l-l-l-l-l-w-w-w-w-l-l-l-l-w-w-w-w-w-w-w-w-w-w-w-w-l-l-l-l-l-l-l-l-l-l-l-l-l-l-l-l-l-l-l-l-l-l-w-
w-l-l-l-l-l-l-l-l-l-l-l-l-l-l-l-w-w-w-w-w-w-w-w-w-l-l-l-l-w-w-w-w-w-w-w-w-w-w-w-w-l-l-l-l-l-l-l-l-l-l-l-l-l-l-l-g-g-l-l-l-l-l-w-
w-l-l-l-l-l-l-l-l-l-l-l-l-l-l-l-w-w-w-w-w-w-w-w-w-l-l-l-l-l-l-l-l-l-l-l-l-l-l-l-l-l-l-l-r-l-l-l-l-l-l-l-l-l-l-l-g-g-l-l-l-l-l-w-
w-l-l-l-l-l-l-l-l-l-l-l-l-l-l-l-w-w-w-w-w-w-w-w-w-l-l-l-l-l-l-l-l-l-l-l-l-l-l-l-l-l-l-l-l-l-l-l-l-l-l-l-l-l-l-l-l-l-l-l-l-l-l-w-
w-l-l-l-l-l-l-l-l-l-g-g-l-l-l-l-w-w-w-w-w-w-w-w-w-l-l-l-l-l-l-l-l-l-l-l-l-l-l-l-l-l-l-l-l-l-l-l-l-l-l-l-l-l-l-l-l-l-l-l-l-l-l-w-
w-l-l-l-m-l-l-l-l-l-g-g-l-l-l-l-l-l-l-l-l-l-w-w-w-w-w-w-w-w-l-l-l-l-w-w-w-w-w-w-w-w-l-l-l-l-l-l-l-l-l-l-l-l-l-l-l-l-l-l-l-l-l-w-
w-l-l-l-l-l-l-l-l-l-l-l-l-l-l-l-l-l-l-l-l-l-w-w-w-w-w-w-w-w-l-l-l-l-w-w-w-w-w-w-w-w-l-l-l-l-l-m-l-l-l-l-l-l-w-w-w-w-l-l-l-l-l-w-
w-l-l-l-l-l-l-l-l-l-l-l-l-l-l-l-l-r-l-l-l-l-w-w-w-w-w-w-w-w-l-l-l-l-w-w-w-w-w-w-w-w-l-l-l-l-l-l-l-l-l-l-l-l-w-w-w-w-l-l-l-l-l-w-
w-l-l-l-l-l-l-l-l-l-l-l-l-l-l-l-l-l-l-l-l-l-w-w-w-l-l-l-l-l-l-l-l-l-l-l-l-l-l-w-w-w-l-l-l-l-l-l-l-l-l-l-l-l-w-w-w-w-l-l-l-l-l-w-
w-l-l-l-l-l-l-l-l-l-l-l-l-l-l-l-u-u-u-u-l-l-w-w-w-l-l-l-l-l-l-l-l-l-l-l-l-l-l-w-w-w-l-l-l-l-l-l-l-l-l-l-l-l-w-w-w-w-l-l-l-l-l-w-
w-l-l-l-l-l-g-g-l-l-l-m-l-l-l-l-l-l-l-l-l-l-w-w-w-l-l-l-l-l-l-l-l-l-l-l-l-l-l-w-w-w-l-l-l-l-l-l-l-l-l-l-l-l-w-w-w-w-l-l-l-l-l-w-
w-l-l-l-l-l-g-g-l-l-l-l-l-l-l-l-l-l-l-l-l-l-w-w-w-l-l-l-l-l-l-l-l-l-l-l-l-l-l-w-w-w-l-l-l-l-l-l-l-l-l-l-l-l-w-w-w-w-l-l-l-l-l-w-
w-l-l-l-l-l-l-l-l-l-l-l-l-l-l-l-l-l-l-l-l-l-w-w-w-w-w-w-w-w-w-w-w-w-w-l-l-l-l-w-w-w-w-w-w-w-w-w-w-w-w-w-w-w-w-w-w-w-l-l-l-l-l-w-
w-l-l-l-l-l-l-l-l-l-l-l-l-l-l-l-l-l-l-l-l-l-w-w-w-w-w-w-w-w-w-w-w-w-w-l-l-l-l-w-w-w-w-w-w-w-w-w-w-w-w-w-w-w-w-w-w-w-l-l-l-l-l-w-
w-l-l-l-m-l-l-l-l-l-l-l-l-w-w-w-w-w-w-w-w-w-w-w-w-w-w-w-w-w-w-w-w-w-w-l-l-l-l-w-w-w-w-w-w-w-w-w-w-w-w-w-w-w-w-w-w-w-l-l-l-l-l-w-
w-l-l-l-l-l-l-l-l-l-l-l-l-w-w-w-w-w-w-w-w-w-w-w-w-w-w-w-w-w-w-w-w-w-w-l-l-l-l-w-w-w-w-w-w-w-w-w-w-w-w-w-w-w-w-w-w-w-l-l-l-l-l-w-
w-l-l-l-l-l-l-l-l-l-l-l-l-w-w-w-w-w-w-w-w-w-w-w-w-w-w-w-w-w-w-w-w-w-w-l-l-l-l-w-w-w-w-w-w-w-w-w-w-w-w-w-w-w-w-w-w-w-l-l-l-l-l-w-
w-w-w-w-w-w-w-w-w-l-l-l-l-w-w-w-w-w-w-w-w-w-w-w-w-w-w-w-w-w-w-w-w-w-w-l-l-l-l-w-w-w-l-l-l-l-l-l-l-l-l-l-l-l-l-l-l-l-l-l-l-l-l-w-
w-w-w-w-w-w-w-w-w-l-l-l-l-w-w-w-w-w-w-w-w-w-w-w-w-w-w-w-w-w-w-w-w-w-w-l-l-l-l-w-w-w-l-l-l-l-l-l-l-l-l-l-m-l-l-l-l-l-l-l-l-l-l-w-
w-w-w-w-w-w-w-w-w-l-l-l-l-w-w-w-w-w-w-w-w-l-l-l-l-l-l-l-l-l-u-l-l-l-l-l-l-l-l-w-w-w-l-l-l-l-l-l-l-l-l-l-l-l-l-l-l-l-l-l-l-l-l-w-
w-w-w-w-w-w-w-w-w-l-l-l-l-w-w-w-w-w-w-w-w-l-l-l-l-l-o-l-l-l-u-l-l-l-l-l-l-l-l-w-w-w-l-l-l-l-l-l-l-l-l-l-l-l-l-l-l-l-l-l-l-l-l-w-
w-w-w-w-w-w-w-w-w-l-l-l-l-l-l-l-l-l-w-w-w-l-l-l-l-l-l-l-l-l-u-l-l-l-l-l-l-l-l-w-w-w-b-b-b-b-w-w-w-w-w-w-w-w-b-b-b-b-w-w-w-w-w-w-
w-w-w-w-w-w-w-w-w-l-l-l-l-l-l-l-l-l-w-w-w-l-l-l-l-l-u-u-u-u-u-l-l-l-l-l-l-l-l-w-w-w-l-l-l-l-w-w-w-w-w-w-w-w-l-l-l-l-w-w-w-w-w-w-
w-w-w-w-w-w-w-w-w-l-l-l-l-l-l-l-l-l-w-w-w-l-l-l-l-l-u-l-l-l-l-l-l-l-l-w-w-w-w-w-w-w-l-l-l-l-w-w-w-w-w-w-w-w-l-l-l-l-w-w-w-w-w-w-
w-w-w-w-w-w-w-w-w-l-l-l-l-l-l-l-l-l-w-w-w-l-l-o-l-l-u-l-l-l-l-l-l-l-l-w-w-w-w-w-w-w-l-l-l-l-w-w-w-w-w-w-w-w-l-l-l-l-w-w-w-w-w-w-
w-l-l-l-l-l-l-l-b-l-l-l-l-l-w-w-w-w-w-w-w-l-l-l-l-l-u-l-l-l-l-l-l-l-l-w-w-w-w-w-w-w-l-l-l-l-l-l-l-l-l-l-l-l-l-l-l-l-l-l-l-l-l-w-
w-l-q-l-l-l-l-l-b-l-l-l-l-l-w-w-w-w-w-w-w-l-l-l-l-l-u-l-l-l-l-l-l-l-l-w-w-w-w-w-w-w-l-l-l-l-l-m-l-l-l-l-l-l-l-l-l-l-l-l-l-q-l-w-
w-l-q-l-l-l-l-l-b-l-l-l-l-l-w-w-w-w-w-w-w-l-l-l-l-l-u-l-l-l-l-l-l-l-l-w-w-w-w-w-w-w-l-l-l-l-l-l-l-l-l-l-l-l-l-l-l-l-l-l-l-q-l-w-
w-l-l-l-l-l-l-l-b-l-l-l-l-l-w-w-w-w-w-w-w-l-l-l-l-l-u-u-u-u-u-b-u-u-u-w-w-w-w-w-w-w-l-l-l-l-l-l-l-l-l-l-l-l-l-l-l-l-l-l-l-l-l-w-
w-w-w-w-w-w-w-w-w-w-l-l-l-l-w-w-w-w-w-w-w-l-l-l-l-l-l-l-l-l-l-l-l-l-l-w-w-w-w-w-w-w-l-l-l-l-w-w-w-w-w-w-w-w-w-w-w-w-w-w-w-w-w-w-
w-w-w-w-w-w-w-w-w-w-l-l-l-l-w-w-w-w-w-w-w-l-l-l-l-l-l-l-l-l-q-l-q-l-l-w-w-l-l-l-l-l-l-l-l-l-w-w-w-w-w-w-w-w-w-w-w-w-w-w-w-w-w-w-
w-w-w-w-w-w-w-w-w-w-l-l-l-l-w-w-w-w-w-w-w-l-l-l-l-l-l-l-q-l-l-l-l-l-l-w-w-l-l-l-l-l-l-l-l-l-w-w-w-w-w-w-w-w-w-w-w-w-w-w-w-w-w-w-
w-w-w-w-w-w-w-w-w-w-l-l-l-l-w-w-w-w-w-w-w-l-l-l-l-l-l-l-l-l-l-l-l-l-l-w-w-l-l-q-l-l-l-l-l-l-w-w-w-w-w-w-w-w-w-w-w-w-w-w-w-w-w-w-
w-w-w-w-w-w-w-w-w-w-l-l-l-l-w-w-w-w-w-w-w-w-w-w-w-w-w-w-w-w-w-w-w-w-w-w-w-l-l-l-l-l-l-l-l-l-w-w-w-w-w-w-w-w-w-w-w-w-w-w-w-w-w-w-	
w-w-w-w-w-w-w-w-w-w-l-l-l-l-w-w-w-w-w-w-w-w-w-w-w-w-w-w-w-w-w-w-w-w-w-w-w-w-w-w-w-l-l-l-l-l-w-w-w-w-w-w-w-w-w-w-w-w-w-w-w-w-w-w-
w-w-w-w-w-w-w-w-w-w-l-l-l-l-w-w-w-w-w-w-w-w-w-w-w-w-w-w-w-w-w-w-w-w-w-w-w-w-w-w-w-l-l-l-l-l-w-w-w-w-w-w-w-w-w-w-w-w-w-w-w-w-w-w-
w-l-l-l-l-l-l-l-l-l-l-l-l-l-l-l-l-l-l-l-l-l-l-w-w-w-w-w-w-w-w-w-w-w-w-w-w-w-w-w-w-l-l-l-l-l-l-l-l-l-l-l-l-l-l-l-l-l-b-l-l-l-l-w-
w-l-l-l-l-l-l-l-l-l-l-l-l-l-l-l-l-l-l-l-l-l-l-w-w-w-w-w-w-w-w-w-w-w-w-w-w-w-w-w-w-l-l-l-l-l-l-l-l-l-l-l-l-l-l-l-l-l-b-l-l-q-l-w-
w-l-l-l-l-l-l-l-l-l-l-u-l-l-l-l-l-l-l-l-l-l-l-w-w-w-w-w-w-w-w-w-w-w-w-w-w-w-w-w-w-l-l-l-l-l-l-l-l-l-l-l-l-l-l-l-l-l-b-l-l-q-l-w-
w-l-l-l-l-l-l-l-l-l-l-u-l-l-l-l-l-l-l-l-l-l-l-w-w-w-w-w-w-w-w-w-w-w-w-w-w-w-w-w-w-l-l-l-l-l-l-l-l-l-l-l-l-l-l-l-l-l-b-l-l-l-l-w-
w-l-g-g-l-l-l-l-l-l-l-u-l-l-l-l-l-l-l-l-l-l-l-l-l-l-l-l-l-l-l-l-l-l-l-l-l-l-l-l-l-l-l-l-l-l-w-w-w-w-w-w-w-w-w-w-w-w-w-w-w-w-w-w-
w-l-g-g-l-l-l-l-l-l-l-u-l-l-l-l-l-l-l-l-l-l-l-l-l-l-l-l-l-l-l-l-l-l-l-l-l-l-l-l-l-l-l-l-l-l-w-w-w-w-w-w-w-w-w-w-w-w-w-w-w-w-w-w-
w-l-l-l-l-l-l-l-r-l-l-l-l-l-l-l-l-l-l-l-l-l-l-l-l-l-l-l-l-l-l-l-l-l-l-l-l-l-l-l-l-l-l-l-l-l-w-w-w-w-w-w-w-w-w-w-w-w-w-w-w-w-w-w-
w-l-l-l-l-l-l-l-l-l-l-l-l-l-l-l-l-l-l-l-l-l-l-l-l-l-l-l-l-l-l-l-l-l-l-l-l-l-l-l-l-l-l-l-l-l-w-w-w-w-w-w-w-w-w-w-w-w-w-w-w-w-w-w-
w-b-b-b-b-w-w-w-w-w-w-w-w-w-w-w-w-w-w-w-w-w-w-w-w-w-w-w-w-l-l-l-l-w-w-w-w-w-w-w-w-l-l-l-l-l-l-l-l-l-l-l-l-l-l-l-r-l-l-l-l-l-l-w-
w-l-l-l-l-w-w-w-w-w-w-w-w-w-w-w-w-w-w-w-w-w-w-w-w-w-w-w-w-l-l-l-l-w-w-w-w-w-w-w-w-l-l-l-l-l-l-l-l-l-g-g-l-l-l-l-l-l-l-l-l-l-l-w-
w-l-l-l-l-w-w-w-w-w-w-w-w-w-w-w-w-w-w-w-w-w-w-w-w-w-w-w-w-l-l-l-l-w-w-w-w-w-w-w-w-l-l-l-l-l-l-l-l-l-g-g-l-l-l-l-l-l-l-l-l-l-l-w-
w-l-l-l-l-w-w-w-w-w-w-w-w-w-w-w-w-w-w-w-w-w-w-w-w-w-w-w-w-l-l-l-l-w-w-w-w-w-w-w-w-l-l-l-l-l-l-l-l-l-l-l-l-l-l-l-l-l-l-l-l-l-l-w-
w-l-l-l-l-l-l-l-l-l-l-r-l-l-l-l-l-l-l-l-l-w-w-w-w-w-w-w-w-l-l-l-l-w-w-w-w-w-w-w-w-l-l-l-l-l-l-l-l-l-l-r-l-l-l-l-l-l-l-l-l-l-l-w-
w-l-l-l-l-l-l-l-l-l-l-l-l-l-l-l-l-l-l-l-l-w-w-w-w-w-w-w-w-l-l-l-l-w-w-w-w-w-w-w-w-w-w-w-w-w-w-w-w-w-w-w-w-w-w-w-w-w-w-l-l-l-l-w-
w-l-l-l-l-l-l-l-l-l-l-l-l-l-l-l-l-l-l-q-l-w-w-w-w-w-w-w-w-l-l-l-l-w-w-w-w-w-w-w-w-w-w-w-w-w-w-w-w-w-w-w-w-w-w-w-w-w-w-l-l-l-l-w-
w-l-l-l-l-l-l-l-l-l-l-l-l-l-l-l-l-l-l-l-l-w-w-w-w-w-w-w-w-l-l-l-l-l-l-l-l-l-w-w-w-w-w-w-w-w-w-w-w-w-w-w-w-w-w-w-w-w-w-l-l-l-l-w-
w-l-l-l-l-m-l-l-l-l-l-l-l-l-l-l-l-l-l-l-l-w-w-w-w-w-w-w-w-l-l-l-l-l-l-l-l-l-w-w-w-w-w-w-w-w-w-w-w-w-w-w-w-w-w-w-w-w-w-l-l-l-l-w-
w-l-l-l-l-l-l-l-l-w-w-w-w-l-l-l-l-l-l-l-l-w-w-w-l-l-l-l-b-l-l-l-l-l-l-l-l-l-w-w-w-l-l-l-l-l-b-l-l-l-l-l-l-l-l-l-l-l-l-l-l-l-l-w-
w-l-l-l-l-l-l-l-l-w-w-w-w-l-l-l-l-l-l-l-l-w-w-w-l-m-l-l-b-l-l-l-l-l-l-l-l-l-w-w-w-l-l-l-l-l-b-l-l-l-l-l-l-l-l-l-l-l-l-l-l-l-l-w-
w-l-l-r-l-l-l-l-l-w-w-w-w-l-l-l-l-l-l-l-l-w-w-w-l-r-l-l-b-l-l-l-l-l-l-l-l-l-w-w-w-l-o-l-l-l-b-l-l-l-l-l-l-l-l-l-l-l-l-l-l-l-l-w-
w-l-l-l-l-l-l-l-l-w-w-w-w-l-l-l-l-l-l-l-l-w-w-w-l-l-l-l-b-l-l-l-l-l-l-l-l-l-w-w-w-l-l-l-l-l-b-l-l-l-l-l-l-l-l-l-l-l-l-l-l-l-l-w-
w-w-w-w-w-w-w-w-w-w-w-w-w-l-l-l-l-w-w-w-w-w-w-w-w-w-w-w-w-l-l-l-l-l-l-l-l-l-w-w-w-l-l-l-l-l-b-l-l-l-l-l-l-l-l-l-l-l-l-l-l-l-l-w-
w-w-w-w-w-w-w-w-w-w-w-w-w-l-l-l-l-w-w-w-w-w-w-w-w-w-w-w-w-l-l-l-l-l-l-l-l-l-w-w-w-w-w-w-w-w-w-w-w-w-w-w-w-w-w-w-w-w-w-w-w-w-w-w-
w-w-w-w-w-w-w-w-w-w-w-w-w-l-l-l-l-w-w-w-w-w-w-w-w-w-w-w-w-l-l-l-l-l-l-l-l-l-w-w-w-w-w-w-w-w-w-w-w-w-w-w-w-w-w-w-w-w-w-w-w-w-w-w-
w-w-w-w-w-w-w-w-w-w-w-w-w-l-l-l-l-w-w-w-w-w-w-w-w-w-w-w-w-l-l-l-l-l-l-l-l-l-w-w-w-w-w-w-w-w-w-w-w-w-w-w-w-w-w-w-w-w-w-w-w-w-w-w-
w-w-w-w-w-w-w-w-w-w-w-w-w-b-b-b-b-w-w-w-w-w-w-w-w-w-w-w-w-l-l-l-l-l-l-l-l-l-w-w-w-w-w-w-w-w-w-w-w-w-w-w-w-w-w-w-w-w-w-w-w-w-w-w-
w-w-w-w-w-w-w-w-w-l-l-l-l-l-l-l-l-l-l-l-l-l-l-l-l-w-w-w-w-l-l-l-l-l-l-l-l-l-w-w-w-w-w-w-w-w-w-w-w-w-w-w-w-w-w-w-w-w-w-w-w-w-w-w-
w-w-w-w-w-w-w-w-w-l-q-l-l-l-l-l-l-l-l-l-l-l-l-o-l-w-w-w-w-l-l-l-l-l-p-l-l-l-w-w-w-w-w-w-w-w-w-w-w-w-w-w-w-w-w-w-w-w-w-w-w-w-w-w-
w-w-w-w-w-w-w-w-w-l-l-l-l-l-l-l-l-l-l-l-l-l-l-l-l-w-w-w-w-l-l-l-l-l-l-l-l-l-w-w-w-w-w-w-w-w-w-w-w-w-w-w-w-w-w-w-w-w-w-w-w-w-w-w-
w-w-w-w-w-w-w-w-w-l-l-l-l-l-l-l-l-l-l-l-l-l-l-l-l-w-w-w-w-l-l-l-l-l-l-l-l-l-w-w-w-w-w-w-w-w-w-w-w-w-w-w-w-w-w-w-w-w-w-w-w-w-w-w-
w-w-w-w-w-w-w-w-w-w-w-w-w-w-w-w-w-w-w-w-w-w-w-w-w-w-w-w-w-w-w-w-w-w-w-w-w-w-w-w-w-w-w-w-w-w-w-w-w-w-w-w-w-w-w-w-w-w-w-w-w-w-w-w-