w-w-w-w-w-w-w-w-w-w-w-w-w-w-w-w-w-w-w-w-w-w-w-w-w-w-w-w-w-w-d-d-d-d-w-w-w-w-w-w-w-w-w-w-w-w-w-w-w-w-w-w-w-w-w-w-w-w-w-w-w-w-w-w-
w-w-l-l-l-l-l-l-l-l-l-l-l-l-l-l-l-l-l-l-l-l-w-w-w-w-w-w-w-w-l-l-l-l-w-w-w-w-w-w-w-w-l-l-l-l-l-l-l-l-l-l-l-l-l-l-l-l-l-l-l-l-w-w-
w-l-l-l-l-l-l-l-l-l-l-l-l-l-l-l-l-l-l-l-l-l-l-w-w-w-w-w-w-w-l-l-l-l-w-w-w-w-w-w-w-l-l-l-l-l-l-l-l-l-l-l-l-l-l-l-l-l-l-l-l-l-l-w-
w-l-l-l-l-l-l-l-l-l-l-l-l-l-l-l-l-l-l-l-l-l-l-w-w-w-w-w-w-w-l-l-l-l-w-w-w-w-w-w-w-l-l-l-l-l-l-l-l-l-l-l-l-l-l-l-l-l-l-l-l-l-l-w-
w-l-l-l-u-u-l-l-l-l-l-l-l-l-g-g-l-l-u-u-l-l-l-w-w-w-w-w-w-w-l-l-l-l-w-w-w-w-w-w-w-l-l-l-l-u-u-u-u-u-u-u-u-u-u-u-u-u-u-l-l-l-l-w-
w-l-l-l-u-u-l-l-l-l-l-l-l-l-g-g-l-l-u-u-l-l-l-w-w-w-w-w-w-w-l-l-l-l-w-w-w-w-w-w-w-l-g-g-l-l-l-l-l-l-l-l-l-l-l-l-l-l-l-l-l-l-l-w-
w-l-l-l-l-l-l-l-l-l-l-l-l-l-l-l-l-l-l-l-l-l-l-w-w-w-w-w-w-w-l-l-l-l-w-w-w-w-w-w-w-l-g-g-l-l-l-l-l-l-l-l-l-l-l-l-l-l-l-l-l-l-l-w-
w-l-l-l-l-l-l-m-l-l-l-l-l-l-l-l-m-l-l-l-l-l-l-w-w-w-w-w-w-w-l-l-l-l-w-w-w-w-w-w-w-l-l-l-l-l-l-l-r-l-l-l-l-l-l-l-m-l-l-l-l-l-l-w-
w-l-l-l-l-l-l-l-b-b-l-l-l-l-b-b-l-l-l-l-l-l-l-w-w-w-w-w-w-w-l-l-l-l-w-w-w-w-w-w-w-l-l-l-l-b-b-b-b-m-l-l-l-l-l-u-u-u-u-l-l-l-l-w-
w-l-l-l-l-l-l-l-b-b-l-l-l-l-b-b-l-l-l-l-l-l-l-w-w-w-w-w-w-w-l-l-l-l-w-w-w-w-w-w-w-l-l-l-l-l-l-l-l-l-l-l-l-l-l-l-r-l-l-l-l-l-l-w-
w-l-l-l-r-l-l-l-l-l-l-l-l-l-l-l-l-l-l-l-m-l-l-w-w-w-w-w-w-w-l-l-l-l-w-w-w-w-w-w-w-l-l-l-l-l-l-l-l-l-l-l-m-l-l-l-l-g-g-l-l-l-l-w-
w-l-l-l-l-g-g-l-l-l-l-l-r-l-l-l-l-l-l-l-l-l-l-w-w-w-w-w-w-w-l-l-l-l-w-w-w-w-w-w-w-l-l-l-l-l-l-l-l-l-u-u-u-u-l-l-l-g-g-l-l-l-l-w-
w-l-l-l-l-g-g-l-l-l-l-l-l-l-l-l-l-g-g-l-l-l-l-w-w-w-w-w-w-w-l-l-l-l-w-w-w-w-w-w-w-l-l-l-l-g-g-l-l-l-u-u-u-u-l-l-l-l-l-l-l-l-l-w-
w-l-l-l-l-l-l-l-l-l-l-l-l-m-l-l-l-g-g-l-l-l-l-w-w-w-w-w-w-w-l-l-l-l-w-w-w-w-w-w-w-l-l-l-l-g-g-l-l-l-l-r-l-l-l-l-l-l-l-l-l-l-l-w-
w-l-l-l-l-l-l-l-b-b-l-l-l-l-b-b-l-l-l-l-l-l-l-l-l-l-l-l-l-l-l-l-l-l-l-l-l-l-l-l-l-l-l-l-l-l-l-m-l-l-l-l-l-l-l-l-l-l-l-l-l-l-l-w-
w-l-l-l-l-l-l-l-b-b-l-l-l-l-b-b-l-l-l-l-l-l-l-l-l-l-l-l-l-l-l-l-l-l-l-l-l-l-l-l-l-l-l-l-l-u-u-u-u-l-l-l-l-l-m-b-b-b-b-l-l-l-l-w-
w-l-l-l-l-l-r-l-l-l-l-l-l-l-l-l-l-l-l-l-l-l-l-l-l-l-l-l-l-l-l-l-l-l-l-l-l-l-l-l-l-l-l-l-l-l-l-l-l-l-l-l-l-l-l-l-l-l-l-l-l-l-l-w-
w-l-l-m-l-l-l-l-l-l-l-l-l-l-l-l-l-l-l-l-l-l-l-l-l-l-l-l-l-l-l-l-l-l-l-l-l-l-l-l-l-l-l-l-l-l-l-l-l-l-l-l-l-l-l-l-l-l-l-l-g-g-l-w-
w-l-l-l-u-u-l-l-l-l-l-g-g-l-l-l-l-l-u-u-l-l-l-w-w-w-w-w-w-w-l-l-l-l-w-w-w-w-w-w-w-l-l-l-l-l-l-l-l-l-l-l-l-l-l-l-l-l-l-l-g-g-l-w-
w-l-l-l-u-u-l-l-l-l-l-g-g-l-l-l-l-l-u-u-l-l-l-w-w-w-w-w-w-w-l-l-l-l-w-w-w-w-w-w-w-l-l-l-l-u-u-u-u-u-u-u-u-u-u-u-u-u-u-l-l-l-l-w-
w-l-l-l-l-l-l-l-l-l-l-l-l-l-l-l-l-l-l-l-l-l-l-w-w-w-w-w-w-w-l-l-l-l-w-w-w-w-w-w-w-l-l-l-l-l-l-l-l-l-l-l-l-l-l-l-l-l-l-l-l-l-l-w-
w-l-l-l-l-l-l-l-l-l-l-l-l-l-l-l-l-l-l-l-l-l-l-w-w-w-w-w-w-w-l-l-l-l-w-w-w-w-w-w-w-l-l-l-l-l-l-l-l-l-l-l-l-l-l-l-l-l-l-l-l-l-l-w-
w-w-l-l-l-l-l-l-l-l-l-l-l-l-l-l-l-l-l-l-l-l-w-w-w-w-w-w-w-w-l-l-l-l-w-w-w-w-w-w-w-w-l-l-l-l-l-l-l-l-l-l-l-l-l-l-l-l-l-l-l-l-w-w-
w-w-w-w-w-w-w-w-w-w-l-l-l-l-w-w-w-w-w-w-w-w-w-w-w-w-w-w-w-w-l-l-l-l-w-w-w-w-w-w-w-w-l-l-l-l-w-w-w-w-w-w-w-w-w-w-w-w-w-w-w-w-w-w-
w-w-w-w-w-w-w-w-w-w-l-l-l-l-w-w-w-w-w-w-w-w-w-w-w-w-w-w-w-w-l-l-l-l-w-w-w-w-w-w-w-w-l-l-l-l-w-w-w-w-w-w-w-w-w-w-w-w-w-w-w-w-w-w-
w-w-w-w-w-w-w-w-w-w-l-l-l-l-w-w-w-w-w-w-w-l-l-l-l-l-l-l-l-l-l-l-l-l-l-w-w-w-w-w-w-w-l-l-l-l-w-w-w-w-w-w-w-w-w-w-w-w-w-w-w-w-w-w-
w-w-w-w-w-w-w-w-w-w-l-l-l-l-w-w-w-w-w-w-w-l-l-h-l-l-l-l-l-l-l-l-l-l-l-w-w-w-w-w-w-w-l-l-l-l-w-w-w-w-w-w-w-w-w-w-w-w-w-w-w-w-w-w-
w-w-w-w-w-w-w-w-w-w-l-l-l-l-w-w-w-w-w-w-w-l-l-u-u-l-l-l-l-l-l-u-u-l-l-w-w-w-w-w-w-w-l-l-l-l-w-w-w-w-w-w-w-w-w-w-w-w-w-w-w-w-w-w-
w-w-w-w-w-w-w-w-w-w-l-l-l-l-w-w-w-w-w-w-w-l-l-u-u-l-l-l-m-l-l-u-u-l-l-w-w-w-w-w-w-w-l-l-l-l-w-w-w-w-w-w-w-w-w-w-w-w-w-w-w-w-w-w-
w-w-w-w-w-w-w-w-w-w-l-l-l-l-w-w-w-w-w-w-w-l-l-l-l-l-l-l-l-l-l-l-l-l-l-w-w-w-w-w-w-w-l-l-l-l-w-w-w-w-w-w-w-w-w-w-w-w-w-w-w-w-w-w-
w-w-w-w-w-w-w-w-w-w-l-l-l-l-w-w-w-w-w-w-w-l-l-l-l-l-l-l-l-l-l-l-l-l-l-w-w-w-w-w-w-w-l-l-l-l-w-w-w-w-w-w-w-w-w-w-w-w-w-w-w-w-w-w-
w-l-l-l-l-l-l-l-l-l-l-l-l-l-l-l-l-l-l-w-w-l-l-l-l-l-l-u-u-l-l-l-o-l-l-w-w-l-l-l-l-l-l-l-l-l-l-l-l-l-l-l-l-l-l-l-l-l-l-l-l-l-l-w-
w-l-q-l-l-l-l-l-l-l-l-l-l-l-l-l-l-l-l-w-w-l-l-l-l-l-l-u-u-l-l-l-l-l-l-w-w-l-q-l-l-l-l-l-l-l-l-l-l-l-l-l-l-l-l-l-l-l-l-l-l-q-l-w-
w-l-q-l-l-l-l-l-l-l-l-l-l-l-l-l-l-q-l-w-w-l-l-l-l-m-l-l-l-l-l-l-l-l-l-w-w-l-l-l-l-l-l-l-l-l-l-l-l-l-l-l-l-l-l-l-l-l-l-l-l-q-l-w-
w-l-l-l-l-l-l-l-l-l-l-l-l-l-l-l-l-l-l-w-w-l-l-l-l-l-l-l-l-l-l-l-l-l-l-w-w-l-l-l-l-l-l-l-l-l-l-l-l-l-l-l-l-l-l-l-l-l-l-l-l-l-l-w-
w-w-w-w-w-w-w-w-w-w-l-l-l-l-w-w-w-w-w-w-w-l-l-u-u-l-l-l-l-l-l-u-u-l-l-w-w-w-w-w-w-w-l-l-l-l-w-w-w-w-w-w-w-w-w-w-w-w-w-w-w-w-w-w-
w-w-w-w-w-w-w-w-w-w-l-l-l-l-w-w-w-w-w-w-w-l-l-u-u-l-l-l-l-l-l-u-u-l-l-w-w-w-w-w-w-w-l-l-l-l-w-w-w-w-w-w-w-w-w-w-w-w-w-w-w-w-w-w-
w-w-w-w-w-w-w-w-w-w-l-l-l-l-w-w-w-w-w-w-w-l-o-l-l-l-l-l-l-l-l-l-h-l-l-w-w-w-w-w-w-w-l-l-l-l-w-w-w-w-w-w-w-w-w-w-w-w-w-w-w-w-w-w-
w-w-w-w-w-w-w-w-w-w-l-l-l-l-w-w-w-w-w-w-w-l-l-l-l-l-l-l-l-l-l-l-l-l-l-w-w-w-w-w-w-w-l-l-l-l-w-w-w-w-w-w-w-w-w-w-w-w-w-w-w-w-w-w-
w-w-w-w-w-w-w-w-w-w-l-l-l-l-w-w-w-w-w-w-w-w-w-w-w-w-w-w-w-w-w-w-w-w-w-w-w-w-w-w-w-w-l-l-l-l-w-w-w-w-w-w-w-w-w-w-w-w-w-w-w-w-w-w-	
w-w-w-w-w-w-w-w-w-w-l-l-l-l-w-w-w-w-w-w-w-w-w-w-w-w-w-w-w-w-w-w-w-w-w-w-w-w-w-w-w-w-l-l-l-l-w-w-w-w-w-w-w-w-w-w-w-w-w-w-w-w-w-w-
w-w-w-w-w-w-w-w-w-w-l-l-l-l-w-w-w-w-w-w-w-w-w-w-w-w-w-w-w-w-w-w-w-w-w-w-w-w-w-w-w-w-l-l-l-l-w-w-w-w-w-w-w-w-w-w-w-w-w-w-w-w-w-w-
w-w-l-l-l-l-l-l-l-l-l-l-l-l-l-l-l-l-l-l-l-l-w-w-w-w-w-w-w-w-w-w-w-w-w-w-w-w-w-w-w-w-l-l-l-l-l-l-l-l-l-l-l-l-l-l-l-l-l-l-l-l-w-w-
w-l-l-l-l-l-l-l-l-l-l-l-l-l-l-l-l-l-l-l-l-l-l-w-w-w-w-w-w-w-w-w-w-w-w-w-w-w-w-w-w-l-l-l-l-l-l-l-l-l-l-l-l-l-l-l-l-l-l-l-l-l-l-w-
w-l-l-l-l-l-l-l-l-l-l-l-l-l-l-l-l-l-l-l-l-l-l-w-w-w-w-w-w-w-w-w-w-w-w-w-w-w-w-w-w-l-l-l-l-l-l-l-l-l-l-l-l-l-l-l-l-l-l-l-l-l-l-w-
w-l-l-l-l-u-u-u-u-u-u-u-u-u-u-u-u-u-u-l-l-l-l-w-w-w-w-w-w-w-w-w-w-w-w-w-w-w-w-w-w-l-l-l-u-u-l-l-l-l-l-m-l-l-g-g-l-l-u-u-l-l-l-w-
w-l-g-g-l-l-l-l-l-l-l-l-l-l-l-l-l-l-l-l-l-l-l-l-l-l-l-l-l-l-l-l-l-l-l-l-l-l-l-l-l-l-l-l-u-u-l-l-l-l-l-l-l-l-g-g-l-l-u-u-l-l-l-w-
w-l-g-g-l-l-l-l-l-l-l-l-l-l-l-l-l-l-l-l-l-l-l-l-l-l-l-l-l-l-l-l-l-l-l-l-l-l-l-l-l-l-l-l-l-l-l-l-l-l-l-l-l-l-l-l-l-l-l-l-l-l-l-w-
w-l-l-l-l-l-l-l-r-l-l-l-l-l-l-l-m-l-l-l-l-l-l-l-l-l-l-l-l-l-l-l-l-l-l-l-l-l-l-l-l-l-l-l-l-l-l-l-l-l-l-l-l-l-l-l-m-l-l-l-l-l-l-w-
w-l-l-l-l-b-b-b-b-m-l-l-l-l-l-u-u-u-u-l-l-l-l-l-l-l-l-l-l-l-l-l-l-l-l-l-l-l-l-l-l-l-l-l-l-l-l-l-b-b-l-l-l-l-b-b-l-l-l-l-l-l-l-w-
w-l-l-l-l-l-l-l-l-l-l-l-l-l-l-l-r-l-l-l-l-l-l-w-w-w-w-w-w-l-l-l-l-w-w-w-w-w-w-w-w-l-l-l-l-l-l-l-b-b-l-l-l-l-b-b-r-l-l-l-l-l-l-w-
w-l-l-l-l-l-l-l-l-l-l-l-m-l-l-l-l-g-g-l-l-l-l-w-w-w-w-w-w-l-l-l-l-w-w-w-w-w-w-w-w-l-l-l-l-l-l-m-l-l-l-l-l-m-l-l-l-l-l-l-l-l-l-w-
w-l-l-l-l-l-l-l-l-l-u-u-u-u-l-l-l-g-g-l-l-l-l-w-w-w-w-w-w-l-l-l-l-w-w-w-w-w-w-w-w-l-l-l-l-g-g-l-l-l-l-l-l-l-l-l-l-l-l-l-l-l-l-w-
w-l-l-l-l-g-g-l-l-l-u-u-u-u-l-l-l-l-l-l-l-l-l-w-w-w-w-w-w-l-l-l-l-w-w-w-w-w-w-w-w-l-l-l-l-g-g-l-l-l-l-l-l-l-l-l-l-g-g-r-l-l-l-w-
w-l-l-l-l-g-g-l-l-l-l-r-l-l-l-l-l-l-l-l-l-l-l-w-w-w-w-w-w-l-l-l-l-w-w-w-w-w-w-w-w-l-l-l-l-l-l-l-l-l-l-l-l-l-l-l-l-g-g-l-l-l-l-w-
w-l-l-l-l-l-l-m-l-l-l-l-l-l-l-l-l-l-l-l-l-l-l-w-w-w-w-w-w-l-l-l-l-w-w-w-w-w-w-w-w-l-l-l-l-l-l-l-b-b-l-l-l-l-b-b-l-l-l-l-l-l-l-w-
w-l-l-l-l-u-u-u-u-l-l-l-l-l-m-b-b-b-b-l-l-l-l-w-w-w-w-w-w-l-l-l-l-w-w-w-w-w-w-w-w-l-l-l-l-l-l-l-b-b-l-l-l-l-b-b-l-l-l-l-l-l-l-w-
w-l-l-l-l-l-l-l-l-l-l-l-l-l-l-l-l-l-l-l-l-l-l-w-l-l-l-l-l-l-l-l-l-l-l-l-l-l-w-w-w-l-l-l-l-l-l-l-l-l-l-l-l-l-l-l-l-l-l-l-l-l-l-w-
w-l-l-l-l-l-l-l-l-l-l-l-l-l-l-l-l-l-l-l-g-g-l-w-l-l-l-l-l-l-l-l-l-l-l-l-l-l-w-w-w-l-l-l-l-l-l-l-l-l-m-l-l-l-l-l-r-l-l-l-l-l-l-w-
w-l-l-l-l-l-l-l-l-l-l-l-l-l-l-l-l-l-l-l-g-g-l-w-w-w-w-w-w-w-w-w-b-b-b-w-w-w-w-w-w-l-l-l-u-u-l-l-l-l-l-g-g-l-l-l-l-l-u-u-l-l-l-w-
w-l-l-l-l-u-u-u-u-u-u-u-u-u-u-u-u-u-u-u-l-l-l-w-l-l-l-l-l-l-l-l-l-l-l-l-l-l-w-w-w-l-l-l-u-u-l-l-l-l-l-g-g-l-r-l-l-l-u-u-l-l-l-w-
w-l-l-l-l-l-l-l-l-l-l-l-l-l-l-l-l-l-l-l-l-l-l-w-l-l-l-l-l-l-l-l-l-l-l-l-l-l-w-w-w-l-l-l-l-l-l-l-l-l-l-l-l-l-l-l-l-l-l-l-l-l-l-w-
w-w-l-l-l-l-l-l-l-l-l-l-l-l-l-l-l-l-l-l-l-l-w-w-l-l-l-l-l-l-l-l-l-l-l-l-l-l-w-w-w-l-l-l-l-l-l-l-l-l-l-l-l-l-l-l-l-l-l-l-l-l-l-w-
w-w-w-w-w-w-w-w-w-w-w-w-w-w-w-w-w-w-w-w-w-w-w-w-w-w-w-b-b-b-w-w-w-w-w-w-w-w-w-w-w-w-l-l-l-l-l-l-l-l-l-l-l-l-l-l-l-l-l-l-l-l-w-w-
w-w-w-w-w-w-w-w-w-w-w-w-w-w-w-w-w-w-w-w-w-w-w-w-l-l-l-l-l-l-l-l-l-l-l-l-l-l-w-w-w-w-w-w-w-w-w-w-w-w-w-w-w-w-w-w-w-w-w-w-w-w-w-w-
w-w-w-w-w-w-w-w-w-w-w-w-w-w-w-w-w-w-w-w-w-w-w-w-l-l-l-l-l-l-l-l-l-l-l-l-l-l-w-w-w-w-w-w-w-w-w-w-w-w-w-w-w-w-w-w-w-w-w-w-w-w-w-w-
w-w-w-w-w-w-w-w-w-w-w-w-w-w-w-w-w-w-w-w-w-w-w-w-l-l-l-l-l-l-l-l-l-l-l-l-l-l-w-w-w-w-w-w-w-w-w-w-w-w-w-w-w-w-w-w-w-w-w-w-w-w-w-w-
w-w-w-w-w-w-w-w-w-w-w-w-w-w-w-w-w-w-w-w-w-w-w-w-l-l-l-l-l-l-l-l-l-l-l-l-l-l-w-w-w-w-w-w-w-w-w-w-w-w-w-w-w-w-w-w-w-w-w-w-w-w-w-w-
w-w-w-w-w-w-w-w-w-w-w-w-w-w-w-w-w-w-w-w-w-w-w-w-w-w-w-w-w-w-b-b-b-w-w-w-w-w-w-w-w-w-w-w-w-w-w-w-w-w-w-w-w-w-w-w-w-w-w-w-w-w-w-w-
w-w-w-w-w-w-w-w-w-w-w-w-w-w-w-w-w-w-w-w-w-w-w-w-l-l-l-l-l-l-l-l-l-l-l-l-l-l-w-w-w-w-w-w-w-w-w-w-w-w-w-w-w-w-w-w-w-w-w-w-w-w-w-w-
w-w-w-w-w-w-w-w-w-w-w-w-w-w-w-w-W-w-w-w-w-w-w-w-l-l-l-l-l-t-l-l-l-l-l-l-l-l-w-w-w-w-w-w-w-w-w-w-w-w-w-w-w-w-w-w-w-w-w-w-w-w-w-w-
w-w-w-w-w-w-w-w-w-w-w-w-w-w-w-w-w-w-w-w-w-w-w-w-l-l-l-l-l-l-l-p-l-l-l-l-l-l-w-w-w-w-w-w-w-w-w-w-w-w-w-w-w-w-w-w-w-w-w-w-w-w-w-w-
w-w-w-w-w-w-w-w-w-w-w-w-w-w-w-w-w-w-w-w-w-w-w-w-w-w-w-w-w-w-w-w-w-w-w-w-w-w-w-w-w-w-w-w-w-w-w-w-w-w-w-w-w-w-w-w-w-w-w-w-w-w-w-w-