w-w-w-w-w-w-d-d-d-d-w-w-w-w-w-w-
w-l-l-l-l-l-l-l-l-l-l-l-l-l-l-w-
w-l-l-l-l-l-l-l-l-l-l-l-l-l-l-w-
w-l-l-l-l-l-l-l-l-l-l-l-l-l-l-w-
w-l-l-l-l-l-l-l-l-l-l-l-l-l-l-w-
w-l-l-l-l-l-l-l-l-l-l-l-l-l-l-w-
w-l-l-l-l-l-l-l-l-l-l-l-l-l-l-w-
w-w-w-b-b-b-w-w-w-w-w-w-w-w-w-w-
w-l-l-l-l-l-l-l-l-l-l-l-l-l-l-w-
w-l-l-l-l-l-l-l-l-l-l-l-l-l-l-w-
w-l-l-l-l-l-l-l-l-l-l-l-l-l-l-w-
w-l-l-l-l-l-l-l-l-l-l-l-l-l-l-w-
w-w-w-w-w-w-w-b-b-b-w-w-w-w-w-w-
w-l-l-l-l-l-l-l-l-l-l-l-l-l-l-w-
w-l-l-l-l-l-l-l-l-l-l-l-l-l-l-w-
w-l-l-l-l-l-l-l-l-l-l-l-l-l-l-w-
w-w-w-w-w-w-w-w-w-w-w-w-w-w-w-w-