w-w-w-w-w-w-w-w-w-w-w-w-w-w-w-w-w-w-w-w-w-w-w-w-w-w-w-w-w-w-w-w-d-w-w-w-w-w-w-w-w-w-w-w-w-w-w-w-w-w-w-w-w-w-w-w-w-w-w-w-w-w-w-w-
w-q-q-l-l-l-l-l-l-l-l-l-l-l-l-l-l-l-l-l-l-q-q-w-w-w-w-w-w-w-l-l-l-l-w-w-w-w-w-w-w-q-q-l-l-l-l-l-l-l-l-l-l-l-l-l-l-l-l-l-l-q-q-w-
w-q-q-l-l-l-l-l-l-l-l-c-l-l-l-l-l-l-l-l-l-q-q-w-w-w-w-w-w-w-l-l-l-l-w-w-w-w-w-w-w-q-q-l-l-l-l-l-l-l-l-r-l-l-l-l-l-l-l-l-l-q-q-w-
w-l-l-l-l-l-l-l-l-l-l-l-l-l-l-l-l-l-l-l-l-l-l-w-w-w-w-w-w-w-l-l-l-l-w-w-w-w-w-w-w-l-l-l-l-m-l-l-l-l-l-l-l-l-l-l-l-l-l-l-l-l-l-w-
w-l-l-l-l-u-u-u-u-u-u-u-u-u-u-u-u-u-u-l-l-l-l-w-w-w-w-w-w-w-l-l-l-l-w-w-w-w-w-w-w-l-l-l-l-u-u-u-u-u-u-u-u-u-u-u-u-u-u-l-l-l-l-w-
w-l-l-l-l-l-l-l-l-l-l-l-l-l-l-l-l-l-l-l-l-l-l-l-l-l-l-l-l-y-l-l-l-l-w-w-w-w-w-w-w-l-l-l-l-l-l-l-l-l-l-l-l-l-l-l-l-l-l-l-l-l-l-w-
w-l-l-l-l-l-l-l-l-l-l-l-l-l-l-l-l-l-l-l-r-l-l-l-l-l-l-l-l-l-l-l-l-l-w-w-w-w-w-w-w-l-l-l-l-l-l-l-l-l-l-g-g-l-l-l-l-l-i-l-l-l-l-w-
w-l-l-l-l-l-l-l-l-l-l-m-l-l-l-l-l-l-l-l-l-l-l-l-l-l-l-l-l-l-l-l-l-l-w-w-w-w-w-w-w-l-l-l-l-b-b-b-b-l-l-g-g-l-l-b-b-b-b-l-l-l-l-w-
w-l-q-q-l-l-l-l-l-l-l-l-l-l-l-l-l-l-l-l-l-l-l-l-l-l-l-l-l-l-l-l-l-l-w-w-w-w-w-w-w-l-l-l-l-b-b-b-b-l-l-l-l-l-l-b-b-b-b-l-l-l-l-w-
w-b-l-l-l-w-w-w-w-w-w-w-w-w-w-w-w-w-w-w-w-w-w-w-w-w-w-w-w-w-l-l-l-l-w-w-w-w-w-w-w-l-l-l-l-l-l-l-l-l-l-l-l-l-l-l-l-l-l-l-l-l-l-w-
w-l-l-l-l-w-w-w-w-w-w-w-w-w-w-w-w-w-w-w-w-w-w-w-w-w-w-w-w-w-l-l-l-l-w-w-w-w-w-w-w-l-l-l-l-l-l-l-l-l-l-l-l-l-l-l-l-l-c-l-l-l-l-w-
w-l-l-l-l-w-w-w-w-w-w-w-w-w-w-w-w-w-w-w-w-w-w-w-w-w-w-w-w-w-l-l-l-l-w-w-w-w-w-w-w-l-l-l-l-u-u-u-u-u-u-u-u-u-u-u-u-u-u-l-l-l-l-w-
w-l-l-r-l-w-w-w-l-l-l-l-l-l-l-l-l-l-l-l-l-l-l-l-l-l-l-l-l-b-l-l-l-l-l-l-l-l-l-l-y-l-l-l-l-l-l-l-l-l-l-l-l-l-l-l-l-l-l-l-l-l-l-w-
w-l-l-l-l-w-w-w-l-o-l-l-l-l-l-l-l-l-l-l-l-l-l-c-l-l-l-l-l-b-l-l-l-l-l-l-l-l-l-l-l-l-l-l-l-l-l-l-l-l-l-l-l-l-l-l-l-l-m-l-l-l-l-w-
w-l-l-l-l-w-w-w-l-h-l-l-l-l-l-l-l-m-l-l-l-l-l-l-l-l-l-l-l-b-l-l-l-l-i-l-l-l-l-l-l-l-l-l-l-l-l-l-r-l-l-l-l-l-l-l-l-l-l-l-l-l-l-w-
w-l-l-l-l-w-w-w-l-l-l-l-l-l-l-l-l-l-l-l-l-l-l-l-l-l-l-l-l-b-l-l-l-l-l-l-l-l-l-l-l-l-l-l-l-l-l-l-l-l-l-l-l-l-l-l-l-l-l-l-l-l-l-w-
w-l-l-l-b-w-w-w-w-w-w-w-w-w-w-w-w-w-w-w-w-w-w-w-w-w-w-w-w-w-w-w-w-w-w-w-w-w-w-w-w-w-w-w-w-w-w-w-w-w-w-w-w-w-w-w-w-w-w-l-l-l-y-w-
w-l-l-l-l-w-w-w-w-w-w-w-w-w-w-w-w-w-w-w-w-w-w-w-w-w-w-w-w-w-w-w-w-w-w-w-w-w-w-w-w-w-w-w-w-w-w-w-w-w-w-w-w-w-w-w-w-w-w-l-q-q-l-w-
w-y-l-l-l-w-w-w-w-w-w-w-w-w-w-w-w-w-w-w-w-w-w-w-w-w-w-w-w-w-w-w-w-w-w-w-w-w-w-w-w-w-w-w-w-w-w-w-w-w-w-w-w-w-w-w-w-w-w-l-l-l-l-w-
w-l-l-l-l-l-l-l-l-y-l-l-l-l-b-l-l-l-l-l-l-l-l-l-l-l-l-l-l-l-l-l-o-l-l-l-l-l-l-l-l-b-l-l-l-l-y-l-l-l-l-l-l-l-l-l-l-l-l-l-l-l-l-w-
w-l-l-m-l-l-l-l-l-l-l-l-l-l-b-l-l-l-l-l-l-l-l-l-l-l-l-l-i-l-l-l-l-l-l-l-l-l-l-l-l-b-l-l-l-l-l-l-l-l-l-l-l-l-l-l-l-l-l-m-l-l-l-w-
w-l-l-l-l-l-l-l-l-l-l-r-l-l-b-l-l-l-l-l-c-l-l-l-l-l-l-l-l-l-l-l-m-l-l-l-l-l-l-l-l-b-l-l-r-l-l-l-l-l-l-l-l-l-l-l-l-l-l-l-l-l-l-w-
w-l-l-l-l-l-l-l-l-l-l-l-l-l-b-l-l-l-l-l-l-l-l-l-l-l-l-l-l-l-l-l-l-l-l-l-l-l-l-l-l-b-l-l-l-l-l-l-l-l-l-l-l-l-l-l-l-l-l-l-l-l-l-w-
w-w-w-w-w-w-w-w-w-w-l-l-l-l-w-w-w-w-w-w-w-w-w-w-w-w-w-w-w-w-w-w-w-w-w-w-w-w-w-w-w-w-l-l-l-l-w-w-w-w-w-w-w-w-w-w-w-w-w-b-b-b-b-w-
w-w-w-w-w-w-w-w-w-w-l-q-q-l-w-w-w-w-w-w-w-w-w-w-w-w-w-w-w-w-w-w-w-w-w-w-w-w-w-w-w-w-l-q-q-l-w-w-w-w-w-w-w-w-w-w-w-w-w-l-l-l-l-w-
w-w-w-w-w-w-w-w-w-w-l-l-l-l-w-w-w-w-w-w-w-w-w-w-w-w-w-w-w-w-w-w-w-w-w-w-w-w-w-w-w-w-l-l-l-l-w-w-w-w-w-w-w-w-w-w-w-w-w-l-q-q-l-w-
w-w-w-w-w-w-w-w-w-w-l-l-l-l-w-w-w-w-w-w-w-w-w-w-w-w-w-w-w-w-l-l-l-l-w-w-w-w-w-w-w-w-l-l-l-l-w-w-w-w-w-w-w-w-w-w-w-w-w-l-l-l-l-w-
w-w-w-w-w-w-w-w-w-w-l-l-l-l-w-w-w-w-w-w-w-w-w-w-w-w-w-w-w-w-l-h-o-l-w-w-w-w-w-w-w-w-l-i-l-l-w-w-w-w-w-w-w-w-w-w-w-w-w-l-l-l-l-w-
w-w-w-w-w-w-w-w-w-w-l-l-m-l-w-w-w-w-w-w-w-w-w-w-w-w-w-w-w-w-l-l-l-l-w-w-w-w-w-w-w-w-l-l-l-l-w-w-w-w-w-w-w-w-w-w-w-w-w-l-l-l-l-w-
w-w-w-w-w-w-w-w-w-w-l-l-l-l-w-w-w-w-w-w-w-w-w-w-w-w-w-w-w-w-l-l-l-l-w-w-w-w-w-w-w-w-l-l-l-l-w-w-w-w-w-w-w-w-w-w-w-w-w-l-l-l-l-w-
w-w-w-w-w-w-w-w-w-w-l-l-l-l-w-w-w-w-w-w-w-w-w-w-w-w-w-w-w-w-l-i-l-l-w-w-w-w-w-w-w-w-l-l-l-l-w-w-w-w-w-w-w-w-w-w-w-w-w-l-l-l-l-w-
w-w-w-w-w-w-w-w-w-w-l-l-l-b-w-w-w-w-w-w-w-w-w-w-w-w-w-w-w-w-l-l-l-l-w-w-w-w-w-w-w-w-b-l-l-l-w-w-w-w-w-w-w-w-w-w-w-w-w-l-l-l-l-w-
w-w-w-w-w-w-w-w-w-w-l-l-l-l-w-w-w-w-w-w-w-w-w-w-w-w-w-w-w-w-l-l-l-l-w-w-w-w-w-w-w-w-l-l-l-l-w-w-w-w-w-w-w-w-w-w-w-w-w-l-c-l-l-w-
w-w-w-w-w-w-w-w-w-w-l-l-l-l-b-l-l-l-l-l-l-l-l-l-l-l-l-l-l-l-l-l-l-l-w-w-w-w-w-w-w-w-l-l-l-l-w-w-w-w-w-w-w-w-w-w-w-w-w-l-l-l-l-w-
w-w-w-w-w-w-w-w-w-w-l-i-l-l-b-l-q-l-l-l-l-l-l-l-l-l-l-l-l-l-l-l-i-l-w-w-w-w-w-w-w-w-l-l-l-l-w-w-w-l-l-l-l-l-l-l-l-l-l-l-l-l-l-w-
w-w-w-w-w-w-w-w-w-w-l-l-l-l-b-l-q-l-l-l-l-l-l-l-l-l-l-l-l-l-l-l-l-l-w-w-w-w-w-w-w-w-l-l-m-l-w-w-w-l-o-l-l-l-l-l-l-l-l-l-l-i-l-w-
w-w-w-w-w-w-w-w-w-w-l-l-l-l-b-l-l-l-l-l-l-l-l-l-l-l-l-l-l-l-l-l-l-l-w-w-w-w-w-w-w-w-l-l-l-l-w-w-w-l-h-l-l-l-l-l-l-l-l-l-l-l-l-w-
w-w-w-w-w-w-w-w-w-w-l-l-l-l-w-w-w-w-w-w-w-w-w-w-w-w-w-w-w-w-l-l-l-l-w-w-w-w-w-w-w-w-l-l-l-l-w-w-w-l-l-l-l-l-l-l-l-l-l-l-l-l-l-w-
w-w-w-w-w-w-w-w-w-w-l-l-l-l-w-w-w-w-w-w-w-w-w-w-w-w-w-w-w-w-l-m-l-l-l-l-l-l-l-l-l-b-l-l-l-l-w-w-w-w-w-w-w-w-w-w-w-w-w-w-w-w-w-w-
w-w-w-w-w-w-w-w-w-w-l-l-l-l-w-w-w-w-w-w-w-w-w-w-w-w-w-w-w-w-l-l-l-l-l-l-l-l-l-q-l-b-l-l-l-l-w-w-w-w-w-w-w-w-w-w-w-w-w-w-w-w-w-w-	
w-w-w-w-w-w-w-w-w-w-l-m-l-l-w-w-w-w-w-w-w-w-w-w-w-w-w-w-w-w-l-l-l-l-l-l-l-l-l-q-l-b-l-l-l-l-w-w-w-w-w-w-w-w-w-w-w-w-w-w-w-w-w-w-
w-w-w-w-w-w-w-w-w-w-b-l-l-l-w-w-w-w-w-w-w-w-w-w-w-w-w-w-w-w-l-l-l-l-l-l-l-l-l-l-l-b-l-l-l-b-w-w-w-w-w-w-w-w-w-w-w-w-w-w-w-w-w-w-
w-w-w-w-w-w-w-w-w-w-l-l-l-l-w-w-w-w-w-w-w-w-w-w-w-w-w-w-w-w-w-w-w-w-w-w-w-w-w-w-w-w-l-l-l-l-w-w-w-w-q-l-l-l-l-l-l-l-l-l-l-q-w-w-
w-w-w-w-w-w-w-w-w-w-l-l-l-l-w-w-w-w-w-w-w-w-w-w-w-w-w-w-w-w-w-w-w-w-w-w-w-w-w-w-w-w-l-l-m-l-w-w-w-w-l-l-l-l-l-l-l-l-l-l-l-l-w-w-
w-w-w-w-w-w-w-w-w-w-l-q-q-l-w-w-w-w-w-w-w-w-w-w-w-w-w-w-w-w-w-w-w-w-w-w-w-w-w-w-w-w-l-l-l-l-w-w-w-w-l-l-l-m-l-l-l-l-l-l-l-l-w-w-
w-w-w-w-w-w-w-w-w-w-l-l-l-l-w-w-w-w-w-w-w-w-w-w-w-w-w-w-w-w-w-w-w-w-w-w-w-w-w-w-w-w-l-q-q-l-w-w-w-w-l-l-l-l-l-l-l-l-l-l-l-l-w-w-
w-w-w-w-w-w-w-w-w-w-l-l-l-y-w-w-w-w-w-w-w-w-w-w-w-w-w-w-w-w-w-w-w-w-w-w-w-w-w-w-w-w-l-l-l-y-w-w-w-w-l-l-l-l-l-l-l-l-l-l-l-l-w-w-
w-q-l-l-l-l-l-l-l-l-l-l-l-l-w-w-w-w-w-l-l-l-l-l-l-l-l-l-y-l-l-l-l-y-b-l-l-l-l-l-l-l-l-l-l-l-l-l-l-l-l-l-l-l-l-l-l-l-r-l-l-l-w-w-
w-l-l-l-l-l-l-l-l-l-l-l-l-l-w-w-w-w-w-l-l-l-l-l-l-l-l-l-l-l-l-l-l-l-b-l-l-l-l-l-l-l-l-l-l-l-l-l-q-l-l-l-l-l-l-l-l-l-l-l-l-l-w-w-
w-l-l-l-l-l-l-r-l-l-l-i-l-l-w-w-w-w-w-t-l-l-l-l-l-l-l-l-l-t-l-l-l-l-b-l-l-l-l-l-l-l-l-l-l-l-l-l-q-l-l-l-l-c-l-l-l-l-l-l-l-l-w-w-
w-l-l-l-l-l-l-l-l-l-l-l-l-l-w-w-w-w-w-l-l-l-l-l-l-l-l-l-l-l-l-l-l-l-b-l-l-l-l-l-l-l-l-l-l-l-l-l-l-y-l-l-l-l-l-l-l-l-l-l-l-l-w-w-
w-l-l-l-b-b-l-l-l-u-l-l-l-l-w-w-w-w-w-l-l-l-l-w-w-w-w-w-w-l-l-l-l-w-w-w-w-w-w-w-w-w-w-w-w-w-w-w-w-w-w-w-w-w-w-w-w-w-b-b-b-b-w-w-
w-l-l-l-b-b-l-l-l-u-l-l-l-l-w-w-w-w-w-l-l-l-l-w-w-w-w-w-w-l-l-l-l-w-w-w-w-w-w-w-w-w-w-w-w-w-w-w-w-w-w-w-w-w-w-w-w-w-l-l-l-l-w-w-
w-l-l-l-l-l-l-l-l-u-l-l-l-l-w-w-w-w-w-l-l-l-l-w-w-w-w-w-w-l-l-l-l-w-w-w-w-w-w-w-w-w-w-w-w-w-w-w-w-w-w-w-w-w-w-w-w-w-l-q-q-l-w-w-
w-l-l-l-l-l-g-g-l-u-l-l-t-l-w-w-w-w-w-l-m-l-l-w-w-w-w-w-w-l-l-l-l-w-w-w-w-w-w-w-w-w-w-w-w-w-l-o-l-l-h-l-o-l-l-w-w-w-l-l-l-l-w-w-
w-l-m-l-l-l-g-g-l-u-l-l-l-l-w-w-w-w-w-l-l-l-l-w-w-w-w-w-w-l-l-l-l-w-w-w-w-w-w-w-w-w-w-w-w-w-l-l-l-l-l-l-l-l-l-w-w-w-l-l-l-l-w-w-
w-l-l-l-l-l-l-l-l-u-l-l-l-l-w-w-w-w-w-l-l-l-l-w-w-w-w-w-w-l-l-l-l-w-w-w-w-w-w-w-w-w-w-w-w-w-l-l-l-l-l-l-l-l-l-w-w-w-l-m-l-l-w-w-
w-l-l-l-l-l-l-l-l-u-l-l-l-l-w-w-w-w-w-l-l-l-l-w-w-w-w-w-w-l-l-l-l-w-w-w-w-w-w-w-w-w-w-w-w-w-l-l-l-l-l-l-l-l-l-w-w-w-l-l-l-l-w-w-
w-l-l-l-b-b-l-l-l-u-l-l-l-l-w-w-w-w-w-l-l-l-l-w-w-w-w-w-w-l-g-g-l-w-w-w-w-w-w-w-w-w-w-w-w-w-l-l-m-l-l-l-l-l-l-w-w-w-l-l-l-l-w-w-
w-l-l-l-b-b-l-l-l-u-l-l-l-l-w-w-w-w-w-l-l-l-l-w-w-w-w-w-w-l-t-l-l-w-w-w-w-w-w-w-w-w-w-w-w-w-l-l-l-l-l-l-l-l-l-w-w-w-l-l-l-l-w-w-
w-l-l-l-l-l-l-l-l-l-l-l-l-l-l-t-l-l-l-l-l-l-l-w-w-w-w-w-w-b-b-b-b-w-w-w-w-w-w-w-w-w-w-w-w-w-l-l-l-l-l-l-l-l-l-w-w-w-l-l-l-l-w-w-
w-l-l-l-l-l-l-l-l-l-l-c-l-l-l-l-l-l-l-l-l-l-l-w-w-w-w-w-w-l-l-l-l-l-l-l-l-l-l-w-w-w-w-w-w-w-l-l-l-l-l-l-l-l-l-w-w-w-l-l-l-l-w-w-
w-l-l-l-l-l-l-l-l-l-l-l-l-l-l-l-l-l-l-l-l-l-l-w-w-w-w-w-w-l-l-l-l-l-l-l-l-l-l-w-w-w-w-w-w-w-l-l-l-l-l-c-l-l-l-l-l-l-l-i-l-l-w-w-
w-q-l-l-l-l-l-l-l-l-l-l-l-l-l-l-l-l-y-l-l-l-l-w-w-w-w-w-w-l-l-l-l-l-l-l-l-l-l-w-w-w-w-w-w-w-l-l-l-l-l-l-l-l-l-l-l-l-l-l-l-l-w-w-
w-w-w-w-w-w-w-w-w-w-w-w-w-w-w-w-w-w-w-w-w-w-w-w-w-w-w-w-w-w-w-w-w-b-b-b-b-w-w-w-w-w-w-w-w-w-l-l-l-l-l-l-l-l-l-l-l-l-l-l-l-l-w-w-
w-w-w-w-w-w-w-w-w-w-w-w-w-w-w-w-w-w-w-w-w-w-w-w-w-w-w-w-w-l-l-l-t-l-l-l-l-l-l-w-w-w-w-w-w-w-w-w-w-w-w-w-w-w-w-w-w-w-w-w-w-w-w-w-
w-w-w-w-w-w-w-w-w-w-w-w-w-w-w-w-w-w-w-w-w-w-w-w-w-w-w-w-w-l-l-l-l-l-l-l-l-l-l-w-w-w-w-w-w-w-w-w-w-w-w-w-w-w-w-w-w-w-w-w-w-w-w-w-
w-w-w-w-w-w-w-w-w-w-w-w-w-w-w-w-w-w-w-w-w-w-w-w-w-w-w-w-w-l-l-l-l-l-l-l-l-l-l-w-w-w-w-w-w-w-w-w-w-w-w-w-w-w-w-w-w-w-w-w-w-w-w-w-
w-w-w-w-w-w-w-w-w-w-w-w-w-w-w-w-w-w-w-w-w-w-w-w-w-w-w-w-w-l-l-l-l-l-l-l-l-l-l-w-w-w-w-w-w-w-w-w-w-w-w-w-w-w-w-w-w-w-w-w-w-w-w-w-
w-w-w-w-w-w-w-w-w-w-w-w-w-w-w-w-w-w-w-w-w-w-w-w-w-w-w-w-w-w-w-w-w-l-l-l-l-w-w-w-w-w-w-w-w-w-w-w-w-w-w-w-w-w-w-w-w-w-w-w-w-w-w-w-
w-w-w-w-w-w-w-w-w-w-w-w-w-w-w-w-w-w-w-w-w-w-w-w-w-w-w-w-w-l-l-l-l-l-l-l-l-l-l-w-w-w-w-w-w-w-w-w-w-w-w-w-w-w-w-w-w-w-w-w-w-w-w-w-
w-w-w-w-w-w-w-w-w-w-w-w-w-w-w-w-W-w-w-w-w-w-w-w-w-w-w-w-w-t-l-l-l-l-l-l-l-l-l-w-w-w-w-w-w-w-w-w-w-w-w-w-w-w-w-w-w-w-w-w-w-w-w-w-
w-w-w-w-w-w-w-w-w-w-w-w-w-w-w-w-w-w-w-w-w-w-w-w-w-w-w-w-w-l-l-p-a-l-l-l-l-l-l-w-w-w-w-w-w-w-w-w-w-w-w-w-w-w-w-w-w-w-w-w-w-w-w-w-
w-w-w-w-w-w-w-w-w-w-w-w-w-w-w-w-w-w-w-w-w-w-w-w-w-w-w-w-w-w-w-w-w-w-w-w-w-w-w-w-w-w-w-w-w-w-w-w-w-w-w-w-w-w-w-w-w-w-w-w-w-w-w-w-