w-w-w-w-w-w-w-w-w-w-w-w-w-w-w-w-w-w-w-w-w-w-w-w-
w-l-l-l-l-l-l-l-l-l-l-l-l-l-l-l-l-l-l-l-l-l-l-w-
w-l-l-l-l-l-l-l-l-l-l-l-l-l-l-l-l-l-l-l-l-l-l-w-
w-l-l-b-b-b-b-b-b-b-u-u-u-u-b-b-b-b-b-b-b-l-l-w-
w-l-l-b-b-b-b-b-b-b-u-u-u-u-b-b-b-b-b-b-b-l-l-w-
w-l-l-g-g-l-l-l-l-l-l-l-l-l-l-l-l-l-l-g-g-l-l-w-
w-l-l-g-g-l-l-l-l-l-l-l-l-l-l-l-l-l-l-g-g-l-l-w-
w-l-l-l-l-l-l-l-l-l-l-l-l-l-l-l-l-l-l-l-l-l-l-w-
w-l-l-b-b-l-l-l-l-l-l-l-l-l-l-l-l-l-l-b-b-l-l-w-
w-l-l-b-b-l-l-l-l-l-l-l-l-l-l-l-l-l-l-b-b-l-l-w-
w-l-l-u-u-l-l-l-l-l-l-l-l-l-l-l-l-l-l-u-u-l-l-w-
w-l-l-u-u-l-l-l-l-l-l-l-l-l-l-l-l-l-l-u-u-l-l-w-
w-l-l-u-u-l-l-l-l-l-l-l-l-l-l-l-l-l-l-u-u-l-l-w-
w-l-l-u-u-l-l-l-l-s-l-l-l-l-l-s-l-l-l-u-u-l-l-w-
w-l-l-b-b-l-l-l-l-l-l-l-l-l-l-l-l-l-l-b-b-l-l-w-
w-l-l-b-b-l-l-l-l-l-l-l-l-l-l-l-l-l-l-b-b-l-l-w-
w-l-l-g-g-l-l-l-l-l-l-l-l-l-l-l-l-l-l-g-g-l-l-w-
w-l-l-g-g-l-l-l-l-l-l-l-l-l-l-l-l-l-l-g-g-l-l-w-
w-b-b-b-b-b-b-b-b-b-b-b-b-b-b-b-b-b-b-b-b-b-b-w-
w-b-b-b-b-b-b-b-b-b-b-b-b-b-b-b-b-b-b-b-b-b-b-w-
w-l-l-l-l-l-l-l-l-l-l-l-l-l-l-l-l-l-l-l-l-l-l-w-
w-l-l-l-l-l-l-l-l-l-p-l-l-a-l-l-l-l-l-l-l-l-l-w-
w-l-l-l-l-l-l-l-l-l-l-l-l-l-l-l-l-l-l-l-l-l-l-w-
w-w-w-w-w-w-w-w-w-w-w-w-w-w-w-w-w-w-w-w-w-w-w-w-