w-w-w-w-w-w-w-w-w-w-w-w-w-w-w-w-w-w-w-w-w-w-w-w-w-w-w-w-w-w-w-w-w-w-w-w-w-w-w-w-w-w-w-w-w-w-w-w-w-w-w-w-d-w-w-w-w-w-w-w-w-w-w-w-
w-l-l-l-l-l-l-l-l-l-l-l-l-l-l-l-l-l-l-l-l-l-l-l-l-l-l-l-l-b-l-l-l-w-w-w-w-l-l-l-l-l-l-l-l-m-l-l-l-l-l-l-l-l-l-l-l-l-l-l-l-l-l-w-
w-l-l-l-l-l-l-l-l-l-l-l-l-l-l-l-l-l-l-l-l-l-l-l-l-l-l-l-l-b-l-l-l-w-w-w-w-l-l-l-l-l-l-l-l-l-l-l-l-l-l-l-l-l-l-r-l-l-l-l-l-l-l-w-
w-l-l-l-l-l-r-l-l-l-l-l-l-l-l-l-l-l-l-l-l-l-l-l-l-l-l-l-l-b-l-q-l-w-w-w-w-l-l-l-l-l-l-l-l-l-l-l-l-l-l-l-l-l-l-l-l-l-l-l-l-l-l-w-
w-l-l-l-l-l-l-l-l-l-l-l-l-l-l-c-l-l-l-l-l-l-l-l-l-l-l-l-l-b-l-l-l-w-w-w-w-l-l-l-l-i-l-l-l-l-l-c-l-l-l-l-l-u-u-u-u-l-l-l-l-l-l-w-
w-l-l-l-u-u-u-u-l-l-l-l-l-l-l-l-l-l-l-l-l-w-w-w-w-l-y-y-y-w-w-w-w-w-w-w-w-w-w-w-w-l-l-l-l-l-l-l-l-l-l-l-l-l-l-l-l-l-l-m-l-l-l-w-
w-l-l-l-l-l-l-l-l-l-l-l-l-l-l-l-l-l-l-l-l-w-w-w-w-l-l-l-l-w-w-w-w-w-w-w-w-w-w-w-w-l-l-l-l-l-l-l-l-l-l-l-l-l-l-l-l-l-l-l-l-l-l-w-
w-l-l-l-l-l-l-l-l-l-l-l-l-l-l-l-w-w-w-w-w-w-w-w-w-l-l-l-l-w-w-w-w-w-w-w-w-w-w-w-w-l-l-l-l-l-l-l-l-l-l-l-l-l-l-l-g-g-l-l-l-l-l-w-
w-l-l-l-l-l-l-l-l-l-l-l-l-l-l-l-w-w-w-w-w-w-w-w-w-l-l-l-l-l-l-l-l-l-l-l-l-l-l-l-l-y-l-l-r-l-l-l-l-l-l-l-l-l-l-l-g-g-l-l-l-l-l-w-
w-l-l-l-l-l-l-l-l-l-l-l-l-l-l-l-w-w-w-w-w-w-w-w-w-l-l-l-l-l-l-l-l-l-l-l-l-l-l-l-l-y-l-l-l-l-l-l-l-l-l-l-l-l-l-l-l-l-l-l-l-l-l-w-
w-l-l-l-l-l-l-l-l-l-g-g-l-l-l-l-w-w-w-w-w-w-w-w-w-l-l-l-l-l-l-l-l-l-l-l-l-l-l-l-l-y-l-l-l-l-l-l-l-l-l-l-l-l-l-l-l-l-l-l-l-l-l-w-
w-l-l-l-m-l-l-l-l-l-g-g-l-l-l-l-l-l-l-l-l-l-w-w-w-w-w-w-w-w-l-y-y-y-w-w-w-w-w-w-w-w-l-l-l-l-l-l-l-l-l-l-l-l-l-l-l-l-l-l-l-l-l-w-
w-l-l-l-l-l-l-l-l-l-l-l-l-l-l-l-l-l-l-l-l-l-w-w-w-w-w-w-w-w-l-l-l-l-w-w-w-w-w-w-w-w-l-l-l-l-u-u-u-u-l-l-l-l-w-w-w-w-l-l-y-y-y-w-
w-l-l-l-l-l-l-l-l-l-l-l-l-l-l-l-l-i-l-l-l-l-w-w-w-w-w-w-w-w-l-l-l-l-w-w-w-w-w-w-w-w-l-l-l-l-l-l-l-l-l-l-l-l-w-w-w-w-l-l-l-l-l-w-
w-l-l-l-l-l-l-l-l-l-l-l-l-l-l-l-l-l-l-l-l-l-w-w-w-l-l-l-l-l-l-l-l-l-l-l-l-l-l-w-w-w-l-l-l-l-l-l-c-l-l-l-l-l-w-w-w-w-l-l-l-l-l-w-
w-l-l-l-l-l-l-l-l-l-l-l-l-l-l-l-u-u-u-u-l-l-w-w-w-l-l-m-l-l-l-l-c-l-l-l-l-l-l-w-w-w-l-l-l-l-l-l-l-l-l-l-l-l-w-w-w-w-l-l-l-l-l-w-
w-l-l-l-l-l-g-g-l-l-l-c-l-l-l-l-l-l-l-l-l-l-w-w-w-l-l-l-l-l-l-l-l-l-l-l-l-l-l-w-w-w-l-l-l-l-l-l-l-l-l-l-l-l-w-w-w-w-l-l-c-l-l-w-
w-l-l-l-l-l-g-g-l-l-l-l-l-l-l-l-l-l-l-l-l-l-w-w-w-l-l-l-l-l-l-l-l-l-l-l-r-l-l-w-w-w-l-l-l-l-l-l-l-l-l-l-l-q-w-w-w-w-l-l-l-l-l-w-
w-l-l-l-l-l-l-l-l-l-l-l-l-l-l-l-l-l-l-l-l-l-w-w-w-w-w-w-w-w-w-w-w-w-w-l-l-l-l-w-w-w-w-w-w-w-w-w-w-w-w-w-w-w-w-w-w-w-l-l-l-l-l-w-
w-l-l-l-l-l-l-l-l-l-l-l-l-l-l-l-l-l-l-l-l-l-w-w-w-w-w-w-w-w-w-w-w-w-w-l-l-l-l-w-w-w-w-w-w-w-w-w-w-w-w-w-w-w-w-w-w-w-l-l-l-l-l-w-
w-l-l-l-m-l-l-l-l-l-l-l-l-w-w-w-w-w-w-w-w-w-w-w-w-w-w-w-w-w-w-w-w-w-w-l-l-l-l-w-w-w-w-w-w-w-w-w-w-w-w-w-w-w-w-w-w-w-l-l-l-l-l-w-
w-l-l-l-l-l-l-l-l-l-l-l-l-w-w-w-w-w-w-w-w-w-w-w-w-w-w-w-w-w-w-w-w-w-w-l-l-i-l-w-w-w-w-w-w-w-w-w-w-w-w-w-w-w-w-w-w-w-l-l-l-l-l-w-
w-l-l-l-l-l-l-l-l-l-l-l-l-w-w-w-w-w-w-w-w-w-w-w-w-w-w-w-w-w-w-w-w-w-w-l-l-l-l-w-w-w-w-w-w-w-w-w-w-w-w-w-w-w-w-w-w-w-l-l-l-l-l-w-
w-w-w-w-w-w-w-w-w-l-y-y-y-w-w-w-w-w-w-w-w-w-w-w-w-w-w-w-w-w-w-w-w-w-w-l-l-l-l-w-w-w-l-l-l-l-l-l-l-l-l-l-l-l-l-l-l-l-l-l-l-l-l-w-
w-w-w-w-w-w-w-w-w-l-l-l-l-w-w-w-w-w-w-w-w-w-w-w-w-w-w-w-w-w-w-w-w-w-w-l-l-l-l-w-w-w-l-l-l-l-l-l-l-l-l-l-m-l-l-l-l-l-l-l-l-l-l-w-
w-w-w-w-w-w-w-w-w-l-l-l-l-w-w-w-w-w-w-w-w-l-l-l-l-l-l-l-l-l-l-l-l-l-l-l-l-l-l-w-w-w-l-l-l-l-l-l-l-l-l-l-l-l-l-l-l-l-l-l-l-l-l-w-
w-w-w-w-w-w-w-w-w-l-l-l-l-w-w-w-w-w-w-w-w-l-l-l-l-l-l-l-l-l-l-l-l-l-l-l-l-l-l-w-w-w-l-l-l-l-l-l-l-l-l-l-l-l-l-l-l-l-l-l-l-l-l-w-
w-w-w-w-w-w-w-w-w-l-l-l-l-l-l-l-l-l-w-w-w-l-l-l-l-l-l-l-c-l-l-l-l-l-l-l-l-l-l-w-w-w-b-b-b-b-w-w-w-w-w-w-w-w-b-b-b-b-w-w-w-w-w-w-
w-w-w-w-w-w-w-w-w-l-l-l-l-l-l-l-q-l-w-w-w-l-l-l-l-l-l-l-l-l-l-l-l-l-l-l-l-l-l-w-w-w-l-l-l-l-w-w-w-w-w-w-w-w-l-l-l-l-w-w-w-w-w-w-
w-w-w-w-w-w-w-w-w-l-l-l-l-l-l-i-l-l-w-w-w-l-l-l-l-l-l-l-l-l-l-l-l-l-l-w-w-w-w-w-w-w-l-l-l-l-w-w-w-w-w-w-w-w-l-l-l-l-w-w-w-w-w-w-
w-w-w-w-w-w-w-w-w-l-l-l-l-l-l-l-l-l-w-w-w-l-l-o-l-l-l-l-c-l-l-l-l-l-l-w-w-w-w-w-w-w-l-l-l-l-w-w-w-w-w-w-w-w-l-l-l-l-w-w-w-w-w-w-
w-l-l-l-l-l-l-l-b-l-l-l-l-l-w-w-w-w-w-w-w-l-l-l-l-l-l-l-l-l-l-l-l-l-l-w-w-w-w-w-w-w-l-l-l-l-l-l-l-l-l-l-l-l-l-l-l-l-l-l-l-l-l-w-
w-l-q-l-l-l-l-l-b-l-l-l-l-l-w-w-w-w-w-w-w-l-l-l-l-l-l-l-l-l-c-l-l-l-l-w-w-w-w-w-w-w-l-l-l-l-l-m-l-l-l-l-l-l-l-l-l-l-l-l-l-q-l-w-
w-l-q-l-l-l-l-l-b-l-l-l-l-l-w-w-w-w-w-w-w-l-l-l-l-l-l-l-l-l-l-l-l-l-l-w-w-w-w-w-w-w-l-l-l-l-l-l-l-l-l-l-l-l-l-l-l-l-l-l-l-q-l-w-
w-l-l-l-l-l-l-l-b-l-l-l-l-l-w-w-w-w-w-w-w-l-o-l-l-l-l-l-l-l-l-l-l-l-l-w-w-w-w-w-w-w-l-l-l-l-l-l-l-l-l-l-l-l-l-l-l-l-l-l-l-l-l-w-
w-w-w-w-w-w-w-w-w-w-l-l-l-l-w-w-w-w-w-w-w-l-l-l-l-l-l-l-l-l-l-l-l-l-l-w-w-w-w-w-w-w-l-l-l-l-w-w-w-w-w-w-w-w-w-w-w-w-w-w-w-w-w-w-
w-w-w-w-w-w-w-w-w-w-l-l-l-l-w-w-w-w-w-w-w-l-l-l-l-l-l-l-l-l-q-l-q-l-l-w-w-l-l-l-l-i-l-l-l-l-w-w-w-w-w-w-w-w-w-w-w-w-w-w-w-w-w-w-
w-w-w-w-w-w-w-w-w-w-l-l-l-l-w-w-w-w-w-w-w-l-l-l-o-l-l-l-q-l-l-l-l-l-l-w-w-l-l-l-l-l-l-l-l-l-w-w-w-w-w-w-w-w-w-w-w-w-w-w-w-w-w-w-
w-w-w-w-w-w-w-w-w-w-l-l-l-l-w-w-w-w-w-w-w-l-l-l-l-l-l-l-l-l-l-l-l-l-l-w-w-l-l-q-l-l-l-l-l-l-w-w-w-w-w-w-w-w-w-w-w-w-w-w-w-w-w-w-
w-w-w-w-w-w-w-w-w-w-l-l-l-l-w-w-w-w-w-w-w-w-w-w-w-w-w-w-w-w-w-w-w-w-w-w-w-l-l-l-l-l-l-l-l-l-w-w-w-w-w-w-w-w-w-w-w-w-w-w-w-w-w-w-	
w-w-w-w-w-w-w-w-w-w-l-l-l-l-w-w-w-w-w-w-w-w-w-w-w-w-w-w-w-w-w-w-w-w-w-w-w-w-w-w-w-l-l-l-l-l-w-w-w-w-w-w-w-w-w-w-w-w-w-w-w-w-w-w-
w-w-w-w-w-w-w-w-w-w-l-y-y-y-w-w-w-w-w-w-w-w-w-w-w-w-w-w-w-w-w-w-w-w-w-w-w-w-w-w-w-l-l-l-l-l-w-w-w-w-w-w-w-w-w-w-w-w-w-w-w-w-w-w-
w-l-l-l-l-l-l-l-l-l-l-l-l-l-l-l-l-l-l-l-l-l-l-w-w-w-w-w-w-w-w-w-w-w-w-w-w-w-w-w-w-l-l-l-l-l-y-l-l-l-l-l-l-l-l-l-l-l-b-l-l-l-l-w-
w-l-l-l-l-l-c-l-l-l-l-l-l-l-l-l-l-l-l-l-l-l-l-w-w-w-w-w-w-w-w-w-w-w-w-w-w-w-w-w-w-l-l-l-l-l-y-l-l-l-l-l-c-l-l-l-l-l-b-l-l-q-l-w-
w-l-l-l-l-l-l-l-l-l-l-u-l-l-l-l-l-l-l-l-l-l-l-w-w-w-w-w-w-w-w-w-w-w-w-w-w-w-w-w-w-l-l-l-l-l-y-l-l-l-l-l-l-l-l-l-l-l-b-l-l-q-l-w-
w-l-l-l-l-l-l-l-l-l-l-u-l-l-l-l-l-l-l-l-l-l-l-w-w-w-w-w-w-w-w-w-w-w-w-w-w-w-w-w-w-l-l-l-l-l-l-l-l-l-l-l-l-l-l-l-l-l-b-l-l-l-l-w-
w-l-g-g-l-l-l-l-l-l-l-u-l-l-l-l-l-l-l-l-l-l-l-l-l-l-l-l-y-l-l-l-l-y-l-l-l-l-l-l-l-l-l-l-l-l-w-w-w-w-w-w-w-w-w-w-w-w-w-w-w-w-w-w-
w-l-g-g-l-l-l-l-l-l-l-u-l-l-l-l-l-l-l-l-l-l-l-l-l-l-l-m-y-l-l-l-l-y-l-c-l-l-l-l-l-l-l-l-l-l-w-w-w-w-w-w-w-w-w-w-w-w-w-w-w-w-w-w-
w-l-l-l-l-l-l-l-r-l-l-l-l-l-l-l-l-l-l-l-l-l-l-l-l-l-l-l-y-l-l-l-l-y-l-l-l-l-l-l-l-l-l-l-l-l-w-w-w-w-w-w-w-w-w-w-w-w-w-w-w-w-w-w-
w-l-l-l-l-l-l-l-l-l-l-l-l-l-l-l-l-l-l-l-l-l-l-l-l-l-l-l-l-l-l-l-l-l-l-l-l-l-l-l-l-l-l-l-l-l-w-w-w-w-w-w-w-w-w-w-w-w-w-w-w-w-w-w-
w-b-b-b-b-w-w-w-w-w-w-w-w-w-w-w-w-w-w-w-w-w-w-w-w-w-w-w-w-l-l-l-l-w-w-w-w-w-w-w-w-l-l-l-l-l-y-l-l-l-l-l-l-l-l-l-r-l-l-l-l-l-l-w-
w-l-y-y-y-w-w-w-w-w-w-w-w-w-w-w-w-w-w-w-w-w-w-w-w-w-w-w-w-l-l-l-l-w-w-w-w-w-w-w-w-l-l-l-l-l-y-l-l-l-g-g-l-l-l-l-l-l-l-l-l-l-l-w-
w-l-l-l-l-w-w-w-w-w-w-w-w-w-w-w-w-w-w-w-w-w-w-w-w-w-w-w-w-l-l-l-l-w-w-w-w-w-w-w-w-l-l-l-l-l-y-l-l-l-g-g-l-l-l-l-l-m-l-l-l-l-l-w-
w-l-l-l-l-w-w-w-w-w-w-w-w-w-w-w-w-w-w-w-w-w-w-w-w-w-w-w-w-l-l-l-l-w-w-w-w-w-w-w-w-l-l-l-l-l-l-l-l-l-l-l-l-l-l-l-l-l-l-l-l-l-l-w-
w-l-l-l-l-l-l-l-l-l-l-r-l-l-l-l-l-l-l-l-l-w-w-w-w-w-w-w-w-l-l-l-l-w-w-w-w-w-w-w-w-l-l-l-l-l-l-l-l-l-l-r-l-l-l-l-l-l-l-l-l-l-l-w-
w-l-l-l-l-l-l-l-l-l-l-l-l-l-l-l-l-l-l-l-l-w-w-w-w-w-w-w-w-l-l-l-l-w-w-w-w-w-w-w-w-w-w-w-w-w-w-w-w-w-w-w-w-w-w-w-w-w-w-l-l-l-l-w-
w-l-l-l-l-l-l-l-l-l-l-l-l-l-l-c-l-l-l-q-l-w-w-w-w-w-w-w-w-l-l-l-l-w-w-w-w-w-w-w-w-w-w-w-w-w-w-w-w-w-w-w-w-w-w-w-w-w-w-l-l-l-l-w-
w-l-l-l-l-l-l-l-l-l-l-l-l-l-l-l-l-l-l-l-l-w-w-w-w-w-w-w-w-l-l-l-l-l-l-l-l-l-w-w-w-w-w-w-w-w-w-w-w-w-w-w-w-w-w-w-w-w-w-l-l-l-l-w-
w-l-l-l-l-m-l-l-l-l-l-l-l-l-l-l-l-l-l-l-l-w-w-w-w-w-w-w-w-l-l-l-l-l-l-l-l-l-w-w-w-w-w-w-w-w-w-w-w-w-w-w-w-w-w-w-w-w-w-l-l-l-l-w-
w-l-l-l-l-l-l-l-l-w-w-w-w-l-l-l-l-l-l-l-l-w-w-w-w-w-w-w-w-l-l-l-l-l-l-l-l-l-w-w-w-l-l-l-l-l-b-l-l-l-l-l-l-l-l-l-l-l-l-l-l-l-l-w-
w-l-l-l-l-l-i-l-l-w-w-w-w-l-l-l-l-l-i-l-l-w-w-w-w-w-w-w-w-l-l-l-l-l-l-l-l-l-w-w-w-l-l-l-l-l-b-l-l-l-l-l-l-l-l-c-l-l-l-l-l-l-l-w-
w-l-l-r-l-l-l-l-l-w-w-w-w-l-l-l-l-l-l-l-l-w-w-w-w-w-w-w-w-l-l-l-l-l-l-l-l-l-w-w-w-l-o-l-l-l-b-l-l-l-l-l-l-l-l-l-l-l-l-l-l-l-l-w-
w-l-l-l-l-l-l-l-l-w-w-w-w-l-l-l-l-l-l-l-l-w-w-w-w-w-w-w-w-l-l-l-l-l-l-l-l-l-w-w-w-l-l-l-l-l-b-l-l-l-l-l-l-l-l-l-l-l-l-l-l-l-l-w-
w-w-w-w-w-w-w-w-w-w-w-w-w-l-l-l-l-w-w-w-w-w-w-w-w-w-w-w-w-l-l-l-l-l-l-l-l-l-w-w-w-l-l-l-l-l-b-l-l-l-l-l-l-l-l-l-l-l-l-l-l-l-l-w-
w-w-w-w-w-w-w-w-w-w-w-w-w-l-l-l-l-w-w-w-w-w-w-w-w-w-w-w-w-l-l-l-l-l-l-l-l-l-w-w-w-w-w-w-w-w-w-w-w-w-w-w-w-w-w-w-w-w-w-w-w-w-w-w-
w-w-w-w-w-w-w-w-w-w-w-w-w-l-l-l-l-w-w-w-w-w-w-w-w-w-w-w-w-l-l-l-l-l-l-l-l-l-w-w-w-w-w-w-w-w-w-w-w-w-w-w-w-w-w-w-w-w-w-w-w-w-w-w-
w-w-w-w-w-w-w-w-w-w-w-w-w-l-l-l-l-w-w-w-w-w-w-w-w-w-w-w-w-l-l-l-l-l-l-l-l-l-w-w-w-w-w-w-w-w-w-w-w-w-w-w-w-w-w-w-w-w-w-w-w-w-w-w-
w-w-w-w-w-w-w-w-w-w-w-w-w-b-b-b-b-w-w-w-w-w-w-w-w-w-w-w-w-l-l-l-l-l-l-l-l-l-w-w-w-w-w-w-w-w-w-w-w-w-w-w-w-w-w-w-w-w-w-w-w-w-w-w-
w-w-w-w-w-w-w-w-w-l-l-l-l-l-l-l-l-l-l-l-l-l-l-l-l-w-w-w-w-l-l-l-l-l-l-l-l-l-w-w-w-w-w-w-w-w-w-w-w-w-w-w-w-w-w-w-w-w-w-w-w-w-w-w-
w-w-w-w-w-w-w-w-w-l-l-l-l-l-l-l-l-l-l-l-l-l-l-o-l-w-w-w-w-l-l-l-p-l-a-l-l-l-w-w-w-w-w-w-w-w-w-w-w-w-w-w-w-w-w-w-w-w-w-w-w-w-w-w-
w-w-w-w-w-w-w-w-w-l-l-l-l-l-l-l-l-l-l-l-l-l-l-l-l-w-w-w-w-l-l-l-l-l-l-l-l-l-w-w-w-w-w-w-w-w-w-w-w-w-w-w-w-w-w-w-w-w-w-w-w-w-w-w-
w-w-w-w-w-w-w-w-w-l-l-l-l-l-l-l-l-l-l-l-l-l-l-l-l-w-w-w-w-l-l-l-l-l-l-l-l-l-w-w-w-w-w-w-w-w-w-w-w-w-w-w-w-w-w-w-w-w-w-w-w-w-w-w-
w-w-w-w-w-w-w-w-w-w-w-w-w-w-w-w-w-w-w-w-w-w-w-w-w-w-w-w-w-w-w-w-w-w-w-w-w-w-w-w-w-w-w-w-w-w-w-w-w-w-w-w-w-w-w-w-w-w-w-w-w-w-w-w-